20
10
28 0 0 0 4 0 0 0 4 0 4 0 0 4 0 0 0 4 0 27 
28 4 0 4 0 0 4 0 0 0 0 4 0 0 4 0 0 0 0 27 
28 0 0 0 0 4 0 0 0 0 0 0 0 0 0 0 4 0 0 27 
28 0 0 0 0 0 0 0 0 0 0 3 0 0 0 0 0 0 0 27 
28 0 0 0 1 0 0 0 0 21 22 22 23 0 0 0 0 0 0 27 
28 0 0 21 22 23 0 0 0 0 0 0 0 0 0 0 0 0 0 27 
28 0 0 0 0 0 0 0 0 2 0 0 0 0 21 22 23 0 0 27 
28 3 0 0 0 0 0 0 30 32 0 0 0 0 0 0 0 3 0 27 
10 22 31 31 31 31 22 22 41 41 22 22 22 22 31 31 31 31 31 10 
10 10 10 10 10 10 10 10 10 10 10 10 10 10 10 10 10 10 10 10 
